"aM" = (/turf/open/floor/almayer{icon_state = "purplefull"; dir = 8},/area/space)
"bc" = (/obj/structure/surface/table/reinforced/black,/turf/open/floor/almayer{icon_state = "emeraldfull"; dir = 1},/area/space)
"bh" = (/obj/structure/machinery/telecomms/hub/preset,/turf/open/floor/almayer{icon_state = "tcomms"},/area/space)
"bB" = (/turf/open/floor/almayer{icon_state = "plating_catwalk"},/area/space)
"bI" = (/obj/structure/machinery/telecomms/relay/preset/telecomms{listening_level = 6},/turf/open/floor/almayer{icon_state = "tcomms"},/area/space)
"bQ" = (/turf/open/floor/almayer{icon_state = "blackcorner"; dir = 4},/area/space)
"ci" = (/obj/structure/machinery/telecomms/server/presets/common,/turf/open/floor/almayer{icon_state = "tcomms"},/area/space)
"cG" = (/obj/structure/machinery/door/airlock/multi_tile/uacm/general{dir = 2; icon = 'icons/obj/structures/doors/2x1engidoor_glass.dmi'; opacity = 0},/turf/open/floor/almayer{icon_state = "plate"},/area/space)
"cM" = (/obj/structure/bed/chair{dir = 4},/turf/open/floor/almayer{icon_state = "blackfull"},/area/space)
"cV" = (/obj/structure/machinery/telecomms/server/presets/squads,/turf/open/floor/almayer{icon_state = "tcomms"},/area/space)
"dt" = (/turf/open/floor/almayer{icon_state = "bluecorner"; dir = 8},/area/space)
"dx" = (/obj/structure/machinery/telecomms/broadcaster/preset_right,/turf/open/floor/almayer{icon_state = "tcomms"},/area/space)
"dR" = (/obj/structure/closet/secure_closet/sp/yellow/g01/engiebasics,/turf/open/floor/almayer{icon_state = "orangefull"},/area/space)
"ek" = (/obj/effect/decal/cargo_stripes{icon_state = "open"},/turf/open/floor/almayer{icon_state = "redfull"},/area/space)
"eq" = (/obj/structure/machinery/telecomms/bus/preset_one,/turf/open/floor/almayer{icon_state = "tcomms"},/area/space)
"eH" = (/obj/structure/machinery/door/airlock/multi_tile/uacm/general{opacity = 0},/turf/open/floor/almayer{icon_state = "plate"},/area/space)
"eX" = (/obj/structure/machinery/door/poddoor/almayer,/turf/open/floor/almayer{icon_state = "plate"},/area/space)
"fb" = (/obj/effect/decal/warning_stripes{icon_state = "S"; pixel_x = -1; pixel_y = 13},/obj/effect/decal/warning_stripes{icon_state = "N"; pixel_x = -1; pixel_y = 21},/obj/effect/decal/warning_stripes{icon_state = "SW-out"; pixel_x = 31; pixel_y = 48},/obj/effect/decal/warning_stripes{icon_state = "E"; pixel_x = 4; pixel_y = 16},/obj/effect/decal/warning_stripes{icon_state = "NW-out"; pixel_x = 31; pixel_y = -14},/turf/open/floor/almayer{icon_state = "bluefull"},/area/space)
"fe" = (/turf/open/floor/almayer{icon_state = "blue"; dir = 1},/area/space)
"fW" = (/obj/structure/bed/chair/comfy/alpha{dir = 8},/turf/open/floor/almayer{icon_state = "bluefull"},/area/space)
"gs" = (/obj/effect/decal/info_tag/sts/pst_interceptor/ext{dir = 8; pixel_y = 16; desc = "OV-PST Interceptor<br><big>- EXT -</big><br>External Airlock"},/turf/open/floor/almayer{icon_state = "redcorner"; dir = 4},/area/space)
"gC" = (/obj/effect/decal/info_tag/sts/pst_interceptor/cry{desc = "OV-PST Interceptor<br><big>- CRY -</big><br>Cryosleep Bays"; dir = 1},/turf/open/floor/almayer{icon_state = "purplecorner"; dir = 2},/area/space)
"he" = (/obj/effect/decal/info_tag/sts/pst_interceptor/twr{desc = "OV-PST Interceptor<br><big>- TWR -</big><br>Y-Positive Twilight Rail"; pixel_y = 16},/turf/open/floor/almayer{icon_state = "orange"; dir = 1},/area/space)
"hK" = (/turf/open/floor/almayer{icon_state = "silver"},/area/space)
"ib" = (/obj/effect/decal/info_tag/sts/pst_interceptor/ext{dir = 8; desc = "OV-PST Interceptor<br><big>- EXT -</big><br>External Airlock"},/turf/open/floor/almayer{icon_state = "red"; dir = 4},/area/space)
"im" = (/obj/effect/decal/cargo_stripes{icon_state = "w"},/turf/open/floor/almayer{icon_state = "redfull"},/area/space)
"iM" = (/turf/open/floor/almayer{icon_state = "orange"; dir = 4},/area/space)
"jd" = (/obj/effect/decal/cargo_stripes{icon_state = "s"},/turf/open/floor/almayer{icon_state = "emeraldfull"; dir = 1},/area/space)
"jr" = (/obj/structure/machinery/door/airlock/multi_tile/uacm/general{dir = 8; opacity = 0; icon = 'icons/obj/structures/doors/2x1prepdoor_charlie.dmi'},/turf/open/floor/almayer{icon_state = "plate"},/area/space)
"km" = (/obj/effect/decal/info_tag/sts/pst_interceptor/car{desc = "OV-PST Interceptor<br><big>- CAR - Cargo Control and Carbo Bays</big><br>"; pixel_x = -16; pixel_y = 16},/turf/open/floor/almayer{icon_state = "emeraldcorner"; dir = 1},/area/space)
"lE" = (/obj/structure/machinery/telecomms/server/presets/command,/turf/open/floor/almayer{icon_state = "tcomms"},/area/space)
"md" = (/obj/structure/bed/chair/comfy/bravo,/turf/open/floor/almayer{icon_state = "orangefull"},/area/space)
"mf" = (/obj/structure/machinery/telecomms/server/presets/engineering,/turf/open/floor/almayer{icon_state = "tcomms"},/area/space)
"mk" = (/turf/open/floor/almayer{icon_state = "emeraldfull"; dir = 1},/area/space)
"ml" = (/obj/effect/decal/info_tag/sts/pst_interceptor/san{desc = "OV-PST Interceptor<br><big>- SAN -</big><br>Toilet and Shower"; dir = 1},/turf/open/floor/almayer{icon_state = "silvercorner"},/area/space)
"mw" = (/obj/structure/sink{pixel_y = -14; dir = 1},/turf/open/floor/almayer{icon_state = "silverfull"},/area/space)
"mz" = (/turf/open/floor/almayer{icon_state = "green"; dir = 1},/area/space)
"mK" = (/turf/open/floor/almayer{icon_state = "blackfull"},/area/space)
"nl" = (/obj/effect/decal/cargo_stripes{icon_state = "open"},/turf/open/floor/almayer{icon_state = "emeraldfull"; dir = 1},/area/space)
"nn" = (/turf/open/floor/almayer{icon_state = "emeraldcorner"; dir = 8},/area/space)
"nH" = (/obj/effect/decal/info_tag/sts/pst_interceptor/med{desc = "OV-PST Interceptor<br><big>- MED -</big><br>Medical Treatment Area"; pixel_x = -16; pixel_y = 16},/turf/open/floor/almayer{icon_state = "greencorner"; dir = 1},/area/space)
"oX" = (/obj/structure/bed/chair/comfy/charlie{dir = 8},/turf/open/floor/almayer{icon_state = "emeraldfull"; dir = 1},/area/space)
"pe" = (/turf/open/floor/almayer,/area/space)
"pj" = (/obj/structure/machinery/cm_vending/sorted/sectorpatrol/soda,/turf/open/floor/almayer{icon_state = "blackfull"},/area/space)
"pk" = (/obj/effect/decal/info_tag/sts/pst_interceptor/wep{desc = "OV-PST Interceptor<br><big>- WEP -</big><br>Secondary Weapon Systems"; dir = 4; pixel_x = -16; pixel_y = 16},/turf/open/floor/almayer{icon_state = "red"; dir = 8},/area/space)
"pK" = (/obj/effect/decal/info_tag/sts/pst_interceptor/eng{desc = "OV-PST Interceptor<br><big>- ENG -</big><br>Damage Control and Engineering Supply"; dir = 4; pixel_x = -16; pixel_y = 0},/turf/open/floor/almayer{icon_state = "orangecorner"; dir = 8},/area/space)
"ql" = (/turf/open/floor/almayer{dir = 9; icon_state = "blue"},/area/space)
"qy" = (/obj/effect/decal/cargo_stripes{icon_state = "nw"},/turf/open/floor/almayer{icon_state = "redfull"},/area/space)
"qD" = (/obj/structure/window/framed/almayer/hull,/turf/open/floor/almayer{icon_state = "tcomms"},/area/space)
"qO" = (/obj/effect/decal/info_tag/sts/pst_interceptor/twr{desc = "OV-PST Interceptor<br><big>- TWR -</big><br>Y-Negative Twilight Rail"; pixel_x = -16; dir = 1},/turf/open/floor/almayer{icon_state = "orange"},/area/space)
"qP" = (/obj/effect/decal/info_tag/sts/pst_interceptor/car{desc = "OV-PST Interceptor<br><big>- CAR - Cargo Control and Carbo Bays</big><br>"; dir = 1},/turf/open/floor/almayer{icon_state = "emeraldcorner"},/area/space)
"re" = (/obj/effect/decal/info_tag/sts/pst_interceptor/rec{desc = "OV-PST Interceptor<br><big>- REC -</big><br>Break Room"; pixel_y = 16; pixel_x = -16},/turf/open/floor/almayer{icon_state = "blackcorner"; dir = 1},/area/space)
"rf" = (/obj/structure/machinery/cryopod/right,/turf/open/floor/almayer{icon_state = "purplefull"; dir = 8},/area/space)
"rr" = (/obj/structure/machinery/telecomms/bus/preset_three,/turf/open/floor/almayer{icon_state = "tcomms"},/area/space)
"rP" = (/obj/structure/machinery/optable,/turf/open/floor/almayer{icon_state = "greenfull"},/area/space)
"sz" = (/obj/structure/machinery/door/airlock/multi_tile/uacm/general{icon = 'icons/obj/structures/doors/2x1secdoor_glass.dmi'; dir = 1},/turf/open/floor/almayer{icon_state = "plate"},/area/space)
"sI" = (/turf/open/space/basic,/area/space)
"tc" = (/obj/structure/surface/table/reinforced/black{pixel_y = 16},/turf/open/floor/almayer{icon_state = "bluefull"},/area/space)
"tm" = (/turf/closed/wall/almayer,/area/space)
"tF" = (/obj/structure/machinery/telecomms/receiver/preset_left,/turf/open/floor/almayer{icon_state = "tcomms"},/area/space)
"tS" = (/obj/structure/machinery/door/airlock/multi_tile/uacm/general{dir = 2; icon = 'icons/obj/structures/doors/2x1almayerdoor.dmi'},/turf/open/floor/almayer{icon_state = "orangefull"},/area/space)
"uc" = (/turf/open/floor/almayer{icon_state = "orange"; dir = 8},/area/space)
"uf" = (/obj/structure/machinery/telecomms/bus/preset_four,/turf/open/floor/almayer{icon_state = "tcomms"},/area/space)
"us" = (/turf/open/floor/almayer{icon_state = "silverfull"},/area/space)
"uE" = (/obj/effect/decal/info_tag/sts/pst_interceptor/cic{desc = "OV-PST Interceptor<br><big>- CIC -</big><br>Combat Information Center"; pixel_x = -16; pixel_y = 16},/turf/open/floor/almayer{icon_state = "bluecorner"; dir = 1},/area/space)
"uK" = (/obj/structure/surface/table/reinforced/black,/turf/open/floor/almayer{icon_state = "bluefull"},/area/space)
"uT" = (/turf/open/floor/almayer{icon_state = "blue"; dir = 8},/area/space)
"vt" = (/obj/structure/surface/table/reinforced/black,/obj/structure/closet/secure_closet/surgical{pixel_x = -30},/turf/open/floor/almayer{icon_state = "greenfull"},/area/space)
"vH" = (/obj/structure/machinery/door/airlock/almayer/uacm/ovpst/general{dir = 1; icon = 'icons/obj/structures/doors/personaldoor.dmi'},/turf/open/floor/almayer{icon_state = "plate"},/area/space)
"vN" = (/turf/open/floor/almayer{icon_state = "redcorner"; dir = 1},/area/space)
"wd" = (/obj/structure/machinery/telecomms/server/presets/security,/turf/open/floor/almayer{icon_state = "tcomms"},/area/space)
"wH" = (/obj/structure/ship_elements/shipprop/power_distribution,/obj/effect/decal/warning_stripes{icon_state = "N-corner"},/turf/open/floor/almayer{icon_state = "orangefull"},/area/space)
"xh" = (/turf/open/floor/almayer{icon_state = "bluecorner"; dir = 1},/area/space)
"xt" = (/turf/open/floor/almayer{icon_state = "emerald"},/area/space)
"xw" = (/turf/open/floor/almayer{icon_state = "silvercorner"; dir = 8},/area/space)
"xZ" = (/obj/structure/machinery/telecomms/server/presets/medical,/turf/open/floor/almayer{icon_state = "tcomms"},/area/space)
"yl" = (/obj/structure/machinery/door/airlock/multi_tile/uacm/general{icon = 'icons/obj/structures/doors/2x1almayerdoor.dmi'},/turf/open/floor/almayer{icon_state = "plate"},/area/space)
"yp" = (/obj/structure/toilet{dir = 4},/turf/open/floor/almayer{icon_state = "silverfull"},/area/space)
"yV" = (/obj/effect/decal/cargo_stripes{icon_state = "s"},/turf/open/floor/almayer{icon_state = "redfull"},/area/space)
"zl" = (/turf/open/floor/almayer{icon_state = "orange"},/area/space)
"zt" = (/obj/structure/surface/rack,/obj/effect/decal/cargo_stripes{icon_state = "n"},/turf/open/floor/almayer{icon_state = "redfull"},/area/space)
"Ag" = (/obj/structure/ship_elements/shipprop/power_distribution,/obj/effect/decal/warning_stripes{icon_state = "SW-in"},/turf/open/floor/almayer{icon_state = "orangefull"},/area/space)
"As" = (/obj/structure/window/framed/almayer/hull,/turf/open/space/basic,/area/space)
"AG" = (/obj/effect/decal/info_tag/sts/pst_interceptor/com{desc = "OV-PST Interceptor<br><big>- COM -</big><br>Liquid Data Communications Array"; dir = 4; pixel_y = 0; pixel_x = -16},/turf/open/floor/almayer{icon_state = "bluecorner"; dir = 8},/area/space)
"AL" = (/turf/open/floor/almayer{icon_state = "orangefull"},/area/space)
"Bc" = (/obj/structure/machinery/shower{dir = 1},/obj/structure/window/reinforced/ultra{dir = 4; name = "shower stall glass wall"; desc = "A piece of hardened glass in a frame."},/obj/structure/window/reinforced/ultra{dir = 8; desc = "A piece of hardened glass in a frame."; name = "shower stall glass wall"},/obj/structure/machinery/door/window/ultra{dir = 1; desc = "A piece of hardened glass in a frame that can slide to the side."; name = "shower stall glass door"},/turf/open/floor/almayer{icon_state = "silverfull"},/area/space)
"Bs" = (/turf/open/floor/almayer{icon_state = "tcomms"},/area/space)
"Ci" = (/obj/structure/surface/rack,/obj/effect/decal/cargo_stripes{icon_state = "open"},/turf/open/floor/almayer{icon_state = "redfull"},/area/space)
"Dk" = (/obj/structure/surface/table/reinforced/black,/turf/open/floor/almayer{icon_state = "orangefull"},/area/space)
"Do" = (/obj/structure/machinery/door/airlock/multi_tile/uacm/general{opacity = 0; icon = 'icons/obj/structures/doors/2x1prepdoor_charlie.dmi'},/turf/open/floor/almayer{icon_state = "plate"},/area/space)
"Dx" = (/turf/open/floor/almayer{icon_state = "orangecorner"},/area/space)
"El" = (/obj/structure/ship_elements/shipprop/power_distribution,/obj/effect/decal/warning_stripes{icon_state = "SE-in"},/turf/open/floor/almayer{icon_state = "orangefull"},/area/space)
"ED" = (/obj/structure/machinery/telecomms/broadcaster/preset_left,/turf/open/floor/almayer{icon_state = "tcomms"},/area/space)
"EJ" = (/turf/open/floor/almayer{icon_state = "emeraldcorner"; dir = 4},/area/space)
"Fj" = (/turf/open/floor/almayer{icon_state = "emerald"; dir = 1},/area/space)
"Fk" = (/turf/open/floor/almayer{icon_state = "purplecorner"; dir = 8},/area/space)
"FP" = (/obj/structure/mirror{pixel_y = -28},/turf/open/floor/almayer{icon_state = "silverfull"},/area/space)
"HB" = (/turf/open/floor/almayer{icon_state = "blue"},/area/space)
"Ik" = (/obj/structure/machinery/cm_vending/sorted/sectorpatrol/food_prepackaged,/turf/open/floor/almayer{icon_state = "blackfull"},/area/space)
"JJ" = (/obj/structure/surface/rack,/obj/effect/decal/cargo_stripes{icon_state = "e"},/turf/open/floor/almayer{icon_state = "emeraldfull"; dir = 1},/area/space)
"Kc" = (/obj/item/storage/firstaid/toxin{pixel_x = 6; pixel_y = 6},/obj/item/storage/firstaid/fire{pixel_x = 3; pixel_y = 3},/obj/item/storage/firstaid/o2,/obj/item/storage/firstaid/adv{pixel_x = 6; pixel_y = 6},/obj/item/storage/firstaid/adv{pixel_x = 3; pixel_y = 3},/obj/item/storage/firstaid/adv,/obj/item/device/healthanalyzer,/obj/item/device/healthanalyzer,/obj/item/device/healthanalyzer,/obj/structure/surface/table/reinforced/prison,/turf/open/floor/almayer{icon_state = "greenfull"},/area/space)
"Kx" = (/obj/effect/decal/warning_stripes{icon_state = "NS-center"},/turf/open/floor/almayer{icon_state = "redfull"},/area/space)
"KA" = (/obj/effect/decal/info_tag/sts/pst_interceptor/cic{desc = "OV-PST Interceptor<br><big>- CIC -</big><br>Combat Information Center"; dir = 1},/turf/open/floor/almayer{icon_state = "bluecorner"},/area/space)
"KE" = (/obj/effect/decal/warning_stripes{icon_state = "SW-in"},/obj/effect/decal/warning_stripes{icon_state = "SE-in"; pixel_y = 0; pixel_x = -7},/turf/open/floor/almayer{icon_state = "redfull"},/area/space)
"Lb" = (/obj/effect/decal/cargo_stripes{icon_state = "nw"},/turf/open/floor/almayer{icon_state = "emeraldfull"; dir = 1},/area/space)
"Lf" = (/turf/open/floor/almayer{icon_state = "greencorner"; dir = 4},/area/space)
"Lz" = (/obj/structure/machinery/telecomms/processor/preset_one,/turf/open/floor/almayer{icon_state = "tcomms"},/area/space)
"LM" = (/turf/open/floor/almayer{dir = 6; icon_state = "orange"},/area/space)
"Mb" = (/obj/vehicle/powerloader{dir = 8},/obj/effect/decal/cargo_stripes,/turf/open/floor/almayer{icon_state = "emeraldfull"; dir = 1},/area/space)
"MP" = (/obj/effect/decal/cargo_stripes{icon_state = "sw"},/turf/open/floor/almayer{icon_state = "emeraldfull"; dir = 1},/area/space)
"Nl" = (/obj/effect/decal/cargo_stripes{icon_state = "n"},/turf/open/floor/almayer{icon_state = "emeraldfull"; dir = 1},/area/space)
"Np" = (/turf/open/floor/almayer{icon_state = "red"; dir = 4},/area/space)
"NR" = (/obj/structure/machinery/cm_vending/sorted/medical/bolted,/turf/open/floor/almayer{icon_state = "greenfull"},/area/space)
"NT" = (/obj/structure/surface/table/reinforced/black,/turf/open/floor/almayer{icon_state = "blackfull"},/area/space)
"Om" = (/obj/structure/machinery/door/airlock/multi_tile/uacm/general/admin{icon = 'icons/obj/structures/doors/2x1almayerdoor_glass.dmi'; opacity = 0},/turf/open/floor/almayer{icon_state = "tcomms"},/area/space)
"Ov" = (/obj/effect/decal/info_tag/sts/pst_interceptor/twr{desc = "OV-PST Interceptor<br><big>- TWR -</big><br>X-Negative Twilight Rail"; dir = 4; pixel_x = -16},/turf/open/floor/almayer{dir = 5; icon_state = "orange"},/area/space)
"OJ" = (/obj/structure/bed/chair/comfy/delta{dir = 8},/turf/open/floor/almayer{icon_state = "bluefull"},/area/space)
"OR" = (/obj/structure/machinery/cryopod,/turf/open/floor/almayer{icon_state = "purplefull"; dir = 8},/area/space)
"PB" = (/obj/structure/machinery/door/airlock/multi_tile/uacm/general{dir = 2; icon = 'icons/obj/structures/doors/2x1almayerdoor.dmi'},/turf/open/floor/almayer{icon_state = "plate"},/area/space)
"Qd" = (/turf/open/floor/almayer{icon_state = "bluefull"},/area/space)
"QQ" = (/obj/effect/decal/info_tag/sts/pst_interceptor/car{desc = "OV-PST Interceptor<br><big>- CAR - Cargo Control and Carbo Bays</big><br>"; dir = 8; pixel_y = 16},/turf/open/floor/almayer{icon_state = "emeraldcorner"; dir = 4},/area/space)
"QT" = (/obj/structure/window/framed/almayer/hull,/turf/open/floor/almayer{icon_state = "plate"},/area/space)
"Rg" = (/obj/effect/decal/cargo_stripes{icon_state = "sw"},/turf/open/floor/almayer{icon_state = "redfull"},/area/space)
"Rl" = (/obj/structure/bed/chair,/turf/open/floor/almayer{icon_state = "blackfull"},/area/space)
"Rm" = (/turf/open/floor/almayer{icon_state = "orangecorner"; dir = 1},/area/space)
"Ru" = (/obj/structure/machinery/cm_vending/sorted/sectorpatrol/cigrette,/turf/open/floor/almayer{icon_state = "blackfull"},/area/space)
"Rw" = (/turf/open/floor/almayer{icon_state = "emeraldcorner"},/area/space)
"SQ" = (/turf/open/floor/almayer{icon_state = "redcorner"},/area/space)
"Th" = (/obj/structure/window/framed/almayer/hull,/turf/open/floor/almayer{icon_state = "plating_catwalk"},/area/space)
"Ti" = (/turf/open/floor/almayer{icon_state = "black"; dir = 1},/area/space)
"Uc" = (/turf/open/floor/almayer{icon_state = "red"; dir = 8},/area/space)
"UA" = (/obj/structure/ship_elements/shipprop/twilight_rail,/turf/open/floor/almayer{icon_state = "tcomms"},/area/space)
"UF" = (/turf/open/floor/almayer{icon_state = "emerald"; dir = 4},/area/space)
"UH" = (/obj/effect/decal/info_tag/sts/pst_interceptor/com{desc = "OV-PST Interceptor<br><big>- COM -</big><br>Liquid Data Communications Array"; dir = 8; pixel_y = 16},/turf/open/floor/almayer{dir = 10; icon_state = "blue"},/area/space)
"Vk" = (/turf/open/floor/almayer{icon_state = "purple"; dir = 2},/area/space)
"Vl" = (/obj/structure/machinery/telecomms/receiver/preset,/turf/open/floor/almayer{icon_state = "tcomms"},/area/space)
"Vo" = (/obj/effect/decal/cargo_stripes{icon_state = "w"},/turf/open/floor/almayer{icon_state = "emeraldfull"; dir = 1},/area/space)
"VE" = (/obj/structure/machinery/bioprinter{stored_metal = 125},/turf/open/floor/almayer{icon_state = "greenfull"},/area/space)
"VT" = (/obj/effect/decal/cargo_stripes,/turf/open/floor/almayer{icon_state = "emeraldfull"; dir = 1},/area/space)
"Wk" = (/obj/effect/decal/info_tag/sts/pst_interceptor/twr{desc = "OV-PST Interceptor<br><big>- TWR -</big><br>X-Positive Twilight Rail"; dir = 8; pixel_y = 16},/turf/open/floor/almayer{icon_state = "orangecorner"; dir = 4},/area/space)
"Wo" = (/obj/effect/decal/warning_stripes{icon_state = "warning"},/turf/closed/wall/almayer,/area/space)
"Wp" = (/obj/effect/decal/info_tag/sts/pst_interceptor/wep{desc = "OV-PST Interceptor<br><big>- WEP -</big><br>Primary Weapons Systems"; dir = 4; pixel_x = -16},/turf/open/floor/almayer{icon_state = "redcorner"; dir = 8},/area/space)
"Ww" = (/obj/structure/machinery/telecomms/bus/preset_two,/turf/open/floor/almayer{icon_state = "tcomms"},/area/space)
"WB" = (/turf/open/floor/almayer{icon_state = "floor"},/area/space)
"WF" = (/obj/structure/machinery/door/airlock/multi_tile/uacm/general{dir = 2; opacity = 0; icon = 'icons/obj/structures/doors/2x1prepdoor_charlie.dmi'},/turf/open/floor/almayer{icon_state = "plate"},/area/space)
"WG" = (/turf/open/floor/almayer{icon_state = "plate"},/area/space)
"WP" = (/obj/structure/machinery/cm_vending/sorted/sectorpatrol/hot_drink,/turf/open/floor/almayer{icon_state = "blackfull"},/area/space)
"WU" = (/turf/open/floor/almayer{icon_state = "greenfull"},/area/space)
"Xs" = (/turf/open/floor/almayer{icon_state = "redfull"},/area/space)
"XB" = (/turf/open/floor/almayer{icon_state = "orange"; dir = 1},/area/space)
"XO" = (/obj/structure/window/framed/almayer/hull,/turf/closed/wall/almayer,/area/space)
"Yq" = (/obj/structure/surface/rack,/obj/effect/decal/cargo_stripes{icon_state = "se"},/turf/open/floor/almayer{icon_state = "emeraldfull"; dir = 1},/area/space)
"YL" = (/obj/structure/machinery/door/airlock/multi_tile/uacm/general/admin{icon = 'icons/obj/structures/doors/Door2x1_secure.dmi'; dir = 1},/turf/open/floor/almayer{icon_state = "plating_catwalk"},/area/space)
"YS" = (/turf/open/floor/almayer{icon_state = "bluecorner"; dir = 4},/area/space)
"ZV" = (/obj/structure/machinery/telecomms/processor/preset_two,/turf/open/floor/almayer{icon_state = "tcomms"},/area/space)
"ZZ" = (/obj/structure/bed/chair{dir = 8},/turf/open/floor/almayer{icon_state = "blackfull"},/area/space)

(1,1,1) = {"
sIsIsIsIsIsIsIsIsIsIsIsIsIsIsIsItmtmtmtmtmtmtmtmsIsIsIsIsIsIsIsIsIsIsIsIsIsIsIsIsIsIsIsI
sIsIsIsIsIsIsIsIsIsIsIsIsIsIsIsItmBsBsBsBsBsBstmsIsIsIsIsIsIsIsIsIsIsIsIsIsIsIsIsIsIsIsI
sIsIsIsIsIsIsIsIsIsIsIsIsIsIsIsItmUABsUABsUABstmsIsIsIsIsIsIsIsIsIsIsIsIsIsIsIsIsIsIsIsI
sIsIsIsIsIsIsIsIsIsIsIsIsIsIsIsItmBsBsBsBsBsBstmsIsIsIsIsIsIsIsIsIsIsIsIsIsIsIsIsIsIsIsI
sIsIsIsIsIsIsIsIsIsIsIsItmtmXOXOtmtmtmylWGtmtmtmXOXOtmtmsIsIsIsIsIsIsIsIsIsIsIsIsIsIsIsI
sIsIsIsIsIsIsIsIsIsIsIsItmrPWUVENRKctmXBhetmRucMNTZZpjtmsIsIsIsIsIsIsIsIsIsIsIsIsIsIsIsI
sIsIsIsIsIsIsIsIsIsIsIsItmvtWUWUWUWUtmpepetmWPmKRlmKIktmsIsIsIsIsIsIsIsIsIsIsIsIsIsIsIsI
sIsIsIsItmtmtmtmtmXOXOXOtmtmtmtmvHtmtmpepetmtmtmvHtmtmtmtmtmtmtmtmXOXOXOtmtmtmThThAsAssI
sIsIsIsIeXXsXsXsKxXsXsXsWGpkpeLfmznHpepepepeWBbQTireWBWBpepepepepepepepepeNpbBbBbBbBbBsI
sIsIsIsIeXXsXsXsKxXsXsXsszUcpepepepeKAHBHBdtpepepepepepepepeqPxtxtnnpepepeNpYLbBbBbBYLsI
sIsIsIsItmXsXsXsKxXsqyzttmvNpetmtmtmtmeHWGtmtmtmtmtmtmpepetmtmDoWGtmtmtmpegstmAsAsAsAssI
sIsIsIsItmXsXsXsKxKEimCitmpepetmuKQdQdQdQdtmciZVufxZtmpepetmJJmkmkVonltmpepetmsIsIsIsIsI
tmtmtmtmtmtmtmtmtmtmtmtmtmpepetmuKfWQdQdQdtmlELzeqmftmpepetmJJmkmkVonltmpepetmtmtmtmtmsI
tmBsBsBstmALALdRdRdRDkALtmpepetmQdQdQdQdQdtmdxBsBsbItmpepetmJJmkmkMPjdtmpepetmBsBsBstmsI
tmUABsBstmOvALALALALmdALtmpKpetmQdQdQdQdqltmqDOmBsqDtmAGRwtmYqmkmkmkmktmpeDxtmBsUABstmsI
tmBsBsBsALiMALALALALALALWGucpetmQdtctcQduTWGWGWGWGWGWGuTUFWGmkmkmkmkMbtmpeiMWGBsBsBstmsI
tmUABsBstSiMALALALALALALcGucpetmfbtcQdQduTPBWGWGWGWGPBuTUFWFmkmkmkmkVTtmpeiMPBBsUABstmsI
tmBsBsBstmLMALALALALALALtmRmpeWoQdtctcQdUHtmqDOmBsqDtmxhQQtmmkmkmkmkmktmpeWktmBsBsBstmsI
tmUABsBstmALElwHwHwHAgALtmpepetmQdQdQdQdQdtmEDbhBsbItmpepetmbcoXmkLbNltmpepetmBsUABstmsI
tmtmtmtmtmtmtmtmtmtmtmtmtmpepetmuKOJQdQdmktmVlLzrrwdtmpepetmbcmkmkVonltmpepetmtmtmtmtmsI
sIsIsIsIeXXsXsXsKxXsimektmpepetmuKQdQdQdQdtmtFZVWwcVtmpepetmmkmkmkVonltmpepetmsIsIsIsIsI
sIsIsIsIeXXsXsXsKxXsRgyVtmWppetmtmtmtmeHWGtmtmtmtmtmtmpepetmtmjrWGtmtmtmpeSQtmAsAsAsAssI
sIsIsIsItmXsXsXsKxXsXsXsWGUcpepepepeYSfefeuEpepepepepepepepeEJFjFjkmpepepeNpbBbBbBbBbBsI
sIsIsIsItmXsXsXsKxXsXsXsszUcpemlhKxwpepepepepegCVkFkpepepepepepepepepepepeibYLbBbBbBYLsI
sIsIsIsItmtmtmtmtmXOXOXOtmtmtmtmvHtmtmpepetmtmtmvHtmtmtmtmtmtmtmtmXOQTQTtmtmtmAsAsAsAssI
sIsIsIsIsIsIsIsIsIsIsIsItmypusususustmpepetmrfaMaMaMORtmsIsIsIsIsIsIsIsIsIsIsIsIsIsIsIsI
sIsIsIsIsIsIsIsIsIsIsIsItmusmwBcFPustmqOzltmrfaMORaMORtmsIsIsIsIsIsIsIsIsIsIsIsIsIsIsIsI
sIsIsIsIsIsIsIsIsIsIsIsItmtmXOXOtmtmtmylWGtmtmtmXOXOtmtmsIsIsIsIsIsIsIsIsIsIsIsIsIsIsIsI
sIsIsIsIsIsIsIsIsIsIsIsIsIsIsIsItmBsBsBsBsBsBstmsIsIsIsIsIsIsIsIsIsIsIsIsIsIsIsIsIsIsIsI
sIsIsIsIsIsIsIsIsIsIsIsIsIsIsIsItmBsBsBsBsBsBstmsIsIsIsIsIsIsIsIsIsIsIsIsIsIsIsIsIsIsIsI
sIsIsIsIsIsIsIsIsIsIsIsIsIsIsIsItmUABsUABsUABstmsIsIsIsIsIsIsIsIsIsIsIsIsIsIsIsIsIsIsIsI
sIsIsIsIsIsIsIsIsIsIsIsIsIsIsIsItmtmtmtmtmtmtmtmsIsIsIsIsIsIsIsIsIsIsIsIsIsIsIsIsIsIsIsI
"}
